D 3 D 5 5 1 3 9 3 9 1 3 B 9 3
B A 9 5 5 6 E A C 6 A A C 6 A
8 4 0 5 5 3 9 6 D 3 A C 5 3 A
8 5 4 5 7 A C 5 5 2 A 9 3 8 2
C 5 5 3 9 4 7 9 5 4 0 2 A A A
9 5 3 A 8 5 3 A D 3 A E 8 4 2
C 7 A A C 7 C 4 3 A C 3 A D 2
9 3 A C 3 9 3 D 4 6 9 6 C 5 2
A A A F C 6 A F F F C 3 B 9 6
A A A F D 5 4 5 5 5 5 4 2 C 3
A C 2 F F F B F F F 9 5 0 5 6
C 3 C 3 B F A F D 5 4 3 C 5 3
9 6 D 0 6 F A F F F 9 6 9 5 6
8 1 3 E 9 1 4 5 5 1 4 3 A 9 3
A A C 5 6 C 5 5 5 6 9 2 A A E
8 2 9 5 5 1 1 3 9 5 6 A 8 4 3
8 6 A 9 1 2 C 2 C 5 3 E C 3 A
C 3 C 6 E 8 3 A 9 3 8 1 3 A A
B C 1 1 3 E A A E A C 6 C 6 A
C 5 4 6 C 5 6 C 5 4 5 5 5 5 6

(0,0)
(13,9)
ESSWSSEEESSSESENESSEEEEEESEENW
